***************
** *** ****   *
**     * ** ***
** ***    * ***
**   ****   ***
**** **** *****
        *      
***************